11111111111
10000000101
10011000101
10000000101
10100000001
10100010101
10100010101
10100000101
10111110101
10000000101
11111111111
